12
11
P--T---T-T-7
E-]L-T-1-+-3
L-T-]E--TJ[3
PT1--J[-+T-J
UE][T--T+1-3
[+--+--+3[-3
^E][1--1+T-7
L1T--7[-+1-3
P-1-]E--17[3
E-]P-1-T-+-3
L--1---1-1-J

